ATK	N
čyevtib	Adv/Komp	čuutij
tátulâd	Adv/2Poss	-tátulávt
parfe	A	Compound
kalje	A	ok
lusme	N	ok
ružže	A	ok
kiäigučuárvág	A	ok
njuálguroobdâg	A	ok
šiervisnjaajâg	N	ok
viiđâuuvsâg	A	ok
saanah	N	ok
farmarpuuvsah	N	ok
leggiŋspuuvsah	N	ok
sapilâsah	N	ok
sirottâsah	N/plural/sirottâs	ok
piškoolodeh	N/plural	lodde	ok
näpiheh	N/plural	nääpih	ok
peŋgâluh	Interj	ok
kerâttuh	N	ok
luobdâh	N	ok
čuuppâh	N	ok
čiäppudâh	N	čiäppuduv	ok
iärgádâh	N	iärgáduv 	ok
tuákádâh	N	tuákáduv 	ok
továdâh		N	továduv	 	ok
vihálâh	N	viháluv		 	ok
luoddiistâh	N			 	ok
čuuvâstâh	N			 	ok
siipuulčevđâstâh	N	 	ok
skirviittâh	N			 	ok
jođáttâh	N			 	ok
pacâttâh	N			 	ok
liivâh	N	ok
uáci	N	uási	ok
näidi	N	nääidi	ok
kuáđfi	N	ok
ciehi	N	cievi	ok
kahcii	Adv	ok
ohcii	Adv	ok
međkki	A	meeđhi#međhis	ok
vieski	N	ok
metki	N/A	ok
ruoški	Interj	ok
poi	Particle	ok
vuotreippi	N	reeipi	ok
snyeltti	N	snyelti	ok
ceevi	N	ok
tuálvi	N	ok
tuárvi	Adv
ruávi	N	ok
lenzi	N	ok
čokoppoođâi	Adv	ok
čokoppođâi	Adv	ok
ryemčči	N/compound	ok
ruomčči	Interj	ok
njeeđi	A	#njeđes
maaŋgâpovijseitik	N
râk	Clitic
kubdâpođâšäskil	N
vaskool	N
siessâl	N
puddâšum	aktio	puddâšuđ
uccáávijđánâm	A/PartPerf	uccáávijđániđ
maakkan	N
motten	Adv
viäštun	Adv
leibišiäráán	N	leibišiäráneh
tátulân	Adv/1Poss	-tátulávt	
iiŋŋân	N
piddo	N	pido
čulkko	N	čulho
totko	N	tođho
jormo	N
nolppo	N
riähhoohaigar	N
äämmir	N
mkr	abbreviation	maŋa Kristus
emas	Conj
toldekes	N	toldiäkká
mandekes	N	mandiäkká
ibles	A	iblá #ibláás
seles	A
toldemes	N
mandemes	N
teres	N	tiärrás
mandeves	N
ruámáriegis	N	ruámáriäggá
äägis	N	ággá~ággás
meeris	N
mieris	N
meerris	N
čuápčis	N	čuápči
ATK-kiäjus	N	ATK-kiäččus
čađadâs	N
kuáskinjâs	N
faaškâs	N	faškâs
čololâs	N/A
hutolâs	N/A
čurvolâs	N/A
hástálâs	N/A
kuvdâlâs	A	
veitâlâs	A
puddorâs	N
het-het	Interj
kárnáiit	N
seekunt	N
viäštust	Adv
moorâst	N
tievâloostâst	Adv
njuácu	N	njáusu
várju	N	váárju
ruávkku	N	ruávhu
ruávru	N	
ranttu	A	raantu #ranttuus~ranttus
luáiđu	N
jieškotteev	Pron
jieškii-uv	Pron
máddá	N	máádá
siähá	A/AdvCompound
kurmá	N
ruámá	N
káisá	N
tivsá	N	tiivsá
spálččá	N	spáálčá
kobbâ	N	koobâ
spahâ	N	spavâ
juo-uv-teikkâ	Particle
tuotkâ	N	tuođhâ
čillâ	N	čiilâ
njollâ	N	njoolâ
koolmâ	N	kolmuu
commâ	N	coomâ
ruomâ	N
covmâ	N	coovmâ
puvnâ	N	puuvnâ
tuodârhilppâ	N
meestâ	N	mestuu
pittâ	N	piitâ
skeerčâ	A	#skerčâ
ruomččâ	Interj
vođđâ	N	voođâ
aldaaš	A/compound
täbibâš	A	täbibáá
koozzâš	N	kozzii
