absolutiv	absolutiv	+?
additiv	additiv	+?
adhortativ	adhortativ	+?
adjunktiv	adjunktiv	+?
alternativ	alternativ	+?
attentiv	attentiv	+?
bisnes	bisnes	+?
desiderativ	desiderativ	+?
distributiv	distributiv	+?
durativ	durativ	+?
englandlâš	englandlâš	+?
gin	gin	+?
govádâs	govádâs	+?
initiv	initiv	+?
innovativ	innovativ	+?
jieijâskiel	jieijâskiel	+?
jieškote	jieškote	+?
juábáškuábáš	juábáškuábáš	+?
kunneeäŋgir	kunneeäŋgir	+?
kuonnâ	kuonnâ	+?
kuullâđ²	kuullâđ²	+?
kuullâđ¹	kuullâđ¹	+?
kyevdil	kyevdil	+?
kyevtkielâl	kyevtkielâl	+?
lijkás	lijkás	+?
lisensiaat	lisensiaat	+?
lágán	lágán	+?
lääni²	lääni²	+?
minareet	minareet	+?
multiplikativ	multiplikativ	+?
má	má	+?
nii	nii	+?
oblikutiv	oblikutiv	+?
omt	omt	+?
oovtâkiel	oovtâkiel	+?
oovtâkielâlâš	oovtâkielâlâš	+?
peeggâlmâs	peeggâlmâs	+?
piippađ	piippađ	+?
preskriptiv	preskriptiv	+?
privativ	privativ	+?
regulativ	regulativ	+?
rocâliđ	rocâliđ	+?
sari	sari	+?
sitativ	sitativ	+?
statutiv	statutiv	+?
tiijmá	tiijmá	+?
timádâs	timádâs	+?
tiätásmuđ	tiätásmuđ	+?
uvgs	uvgs	+?
uđđâsistorniđ	uđđâsistorniđ	+?
viäjuttem	viäjuttem	+?
vuárdámuš	vuárdámuš	+?
šraŋgâpuhelin	šraŋgâpuhelin	+?
